~에 주신다면 감사하겠습니다 / ~에 대해 감사하겠습니다	I would be grateful if you could 동사원형 / I would be grateful for ~	I would be grateful if you could extend the library hours during exam week.
~해주시면 감사하겠습니다	I would appreciate it / It would be appreciated if you could 동사원형	I would appreciate it if you could take a more active role in solving the noise problem.
~에 관해 도움을 주셨으면 합니다	I was hoping you could help me with ~ / I would love your help with ~	I was hoping you could help me with this report.
~에 대해 안내해 주시면 대단히 감사하겠습니다	I would greatly appreciate your guidance/instructions on ~	I would greatly appreciate your guidance on which course I should take next semester.
~을 설명해 주실 수 있나요?	Would you mind clarifying ~?	Would you mind clarifying the required steps to register for the exchange program?
~에 관하여 연락드립니다	I am contacting you regarding ~	I am contacting you regarding the invoice I received last week.
저는 ~에 대한 저의 관심을 표현하기 위해 이메일을 쓰고 있습니다	I am writing to express my interest in ~	I am writing to express my interest in the summer internship program your company is offering.
저는 ~을 요청드리기 위해 이메일을 쓰고 있습니다	I am writing to ask for / request ~	I am writing to ask for information regarding my recent order.
~에 대해 문의드리고 싶습니다	I would like to inquire/ask about ~	I would like to inquire about membership fees at your gym.
~인지 [~하는 게 맞는지] 확인해 주실 수 있나요?	Could you please confirm whether 주어 + 동사?Could you please confirm whether the library will be open during the holidays?
~을 알려 주실 수 있나요?	Could you please let me know ~?	Could you please let me know when my package will arrive?
~에 대해 조언해 주시겠어요 [알려 주시겠어요]?	Could you please advise ~?	Could you please advise me on which document I should submit?
저는 ~하기 때문에 ~에 매우 관심이 있습니다	I am very interested in ~ because 주어 + 동사	I am very interested in studying abroad because it allows me to experience different cultures.
~의 진행 상황[현황]을 알려 주시기 바랍니다	Please provide me with the current status of ~	Please provide me with the current status of my scholarship application.
~이라고 통보받았습니다	I was notified that 주어 + 동사	I was notified that my flight has been canceled due to severe weather conditions.
저는 ~에 대한 몇 가지 우려를 전하기 위해 이메일을 쓰고 있습니다	I am writing to express some concerns about ~	I am writing to express some concerns about the safety of our neighborhood.
~에 대한 긴급한 관심[주의]을 정중히 요청드립니다	I kindly request your urgent attention to ~	I kindly request your urgent attention to a system error on the course registration page.
저는 ~에서 여러 차례 불편한 경험을 한 후 이메일을 쓰고 있습니다	I am writing to you after having had several negative experiences at ~	I am writing to you after having had several negative experiences at your store.
저는 ~을 신고하기 [알리기] 위해 이메일을 쓰고 있습니다	I am writing to report ~	I am writing to report an unauthorized charge on my credit card.
저는 ~하는 중에 제가 겪었던 문제와 관련하여 이메일을 쓰고 있습니다	I am writing regarding an issue I encountered while ~	I am writing regarding an issue I encountered while installing the app.
저는 ~으로 인해 ~할 수 없었습니다	I was unable to 동사원형 due to ~	I was unable to attend the meeting due to a sudden illness.
~한 몇 가지 문제들을 겪었습니다	I ran into a couple of issues that 과거 동사	Unfortunately, I ran into a couple of issues that delayed the project completion.
~는 ~을 겪고 있습니다	주어 has been experiencing ~	I have been experiencing difficulties accessing the website.
안타깝게도, ~하는 중에 A를 겪었습니다	Unfortunately, I encountered A while ~	Unfortunately, I encountered a problem while printing my essay.
저는 ~하다는 것을 알게 되었습니다 [알아차렸습니다]	I've noticed/realized that 주어 + 동사	I've noticed that some students have questions about the upcoming exam.
~가 ~으로 인해 [~에 대해] 불만스러워하고 있습니다	주어 is becoming frustrated by/with ~	The team is becoming frustrated by the unclear instructions.
~는 A뿐 뿐만 아니라 B도 한다	주어 not only A but also B	The problem not only increases costs but also decreases productivity.
A는 B가 ~하기 어렵게 만든다	A makes it difficult for B to 동사원형	The poor Internet connection makes it difficult for me to work from home.
~가 A가 ~하게 만들었습니다	주어 has caused A to 동사원형	The power outage has caused food to spoil in the fridge.
~는 ~하기 때문에 우려됩니다	주어 is troubling because 주어 + 동사	The lack of participation is troubling because it affects the whole team's performance.
~는 A에 큰 영향을 미칩니다	주어 significantly impacts A	Attendance significantly impacts the final grade.
~는 ~하는 데 도움이 될 수 있습니다 / ~는 ~하는 데 도움이 될 것입니다	주어 might help ~ / 주어 would help ~	A reminder app might help you stay on schedule.
가능한 한 가지 해결책은 ~하는 것입니다	One possible solution is to 동사원형	One possible solution is to hire additional staff during peak hours.
추가 문제를 방지하기 위해, ~할 것을 제안합니다	To prevent further issues/incidents, I suggest that 주어 + 동사	To prevent further issues, I suggest that we set rules for study room use.
이 문제를 해결하기 위해, ~하는 것을 제안합니다	To address this issue, I suggest ~	To address this issue, I suggest organizing your schedule in advance.
저는 당신을 ~에 초대하기 위해 이메일을 쓰고 있습니다	I am writing to invite you to ~	I am writing to invite you to our school's annual music festival.
당신을 ~에 초대하고 싶습니다 [~에 당신과 함께하길 바랍니다]	I would like to invite you to ~	I would like to invite you to dinner at my place tomorrow.
당신이 ~에 저와 같이 가주시면 좋겠습니다	I'd love for you to join me at ~	I'd love for you to join me at the community festival.
당신이 함께하기를 정말 바랍니다	I really hope you can join us	I'm arranging a volunteer event next Saturday, and I really hope you can join us.
~하려는 [~을 위한] 제 계획을 알려 드리게 되어 (매우) 기쁩니다	I'm excited to tell you about my plan to 동사원형 / for ~	I'm excited to tell you about my plan to start a small business.
~을 준비하고 있는데 당신이 참석해 주시면 정말 기쁠 것 같습니다	I'm organizing ~ and would be thrilled if you could attend	I'm organizing a birthday party for Amy and would be thrilled if you could attend.
방금 ~에 대한 소식을 들었는데 당신이 관심이 있을 것 같다고 생각했습니다	I was just notified about ~ and thought you would be interested	I was just notified about a photography contest and thought you would be interested.
~는 ~하는 것을 목표로 합니다	주어 aims to 동사원형	Our festival aims to showcase local artists and their unique creations.
~는 ~을 포함한 다양한 활동들을 조직합니다	주어 organizes a range of activities, including ~	We organize a range of activities, including cooking classes, book clubs, and hiking trips.
~는 단지 ~만이 아니라 ~이 될 것입니다	주어 wouldn't just be about ~	The workshop wouldn't just be about learning new skills.
저는 ~할 계획입니다	I'm planning to 동사원형 / I plan to 동사원형	I'm planning to prepare a study guide to help other students review for exams.
~에 시간 되시나요?	Would you be free ~?	Would you be free tomorrow afternoon to meet for our project?
~을 위해 A에서 만나는 건 어때요?	How about we meet at A for ~?	How about we meet at the trail entrance for a walk?
~는 ~에 개최될 예정입니다	주어 will be held on ~ / 주어 takes place ~	The neighborhood yard sale will be held on Saturday in the community park.
제가 ~할 수 있는지 ~까지 알려 주세요	Let me know by ~ so I can 동사원형	Let me know by Friday so I can book the tickets.
~는 우리가 ~할 수 있는 좋은 기회가 될 것입니다	주어 would be a wonderful chance for us to 동사원형	It would be a wonderful chance for us to strengthen our partnership.
~하기 때문에 당신이 ~을 즐길 수 있을 거라고 생각해요	I think you'll enjoy ~ because 주어 + 동사	I think you'll enjoy this movie because it features your favorite actor.
~하는 것이 정말 기대됩니다	Can't wait to 동사원형	Can't wait to see you tomorrow!
~에 대해 감사를 표하고 싶었습니다	I wanted to express my appreciation for ~	I wanted to express my appreciation for your hospitality last weekend.
~에 정말 감사합니다	Thank you very much for ~	Thank you very much for helping me with the assignment.
(~에 대해) 감사의 마음을 전하고 싶었습니다 [표하고 싶었습니다]	I wanted to share/express my gratitude (for ~)	I wanted to share my gratitude for your generosity.
~에 진심으로 감사드립니다	I truly appreciate ~	I truly appreciate your advice on this matter.
~에 대해 다시 한번 감사드립니다	Thanks again for ~	Thanks again for the excellent service at your restaurant.
시간을 내어 ~해 주셔서 감사합니다	Thank you for taking the time to 동사원형	Thank you for taking the time to explain the project details.
~에 대해 아무리 감사드려도 부족합니다	I can't thank you enough for ~	I can't thank you enough for your help during my move.
~에 대해 얼마나 감사했는지 알려 드리고 싶었습니다	I wanted to let you know how much I appreciated ~	I wanted to let you know how much I appreciated your support during my recovery from a surgery.
~는 저에게 정말 큰 의미가 있었고, 감사드리고 싶었습니다	주어 has meant a lot to me, and I wanted to thank you	Your mentorship over the past year has meant a lot to me, and I wanted to thank you.
~에 대해 정말 미안하고, 당신에게 만회하고 싶습니다	I'm so sorry about ~, and I would like to make it up to you	I'm so sorry about cancelling our plans, and I would like to make it up to you.
~에 대해 진심으로 사과드립니다	I sincerely apologize for ~	I sincerely apologize for being late to the meeting.
실수로 ~했고, ~하다는 것이 정말 미안합니다  I accidentally 과거 동사, and I feel absolutely terrible that 주어 + 동사	I accidentally broke your mug, and I feel absolutely terrible that you can't use it anymore.
마지막 순간에 이렇게 해서 정말 죄송하지만, ~해야 합니다	I am so sorry to do this at the last minute, but I have to 동사원형	I am so sorry to do this at the last minute, but I have to cancel our lunch plans today.
~하는 것을 정말 기대했지만, ~합니다	I was really looking forward to ~, but 주어 + 동사	I was really looking forward to watching a movie with you tonight, but I got a fever suddenly.
정말 죄송하지만, ~에 관한 몇 가지 안 좋은 소식이 있습니다	I'm so sorry, but I have some bad news about ~	I'm so sorry, but I have some bad news about our travel plans.
~하게 되어 정말 죄송하지만, ~합니다	I feel really awful having to 동사원형, but 주어 + 동사	I feel really awful having to cancel dinner, but something urgent came up at work.
~을 알려 드려게 되어 유감입니다	I regret to inform you that 주어 + 동사	I regret to inform you that the restaurant is fully booked.
~으로 인해 발생한 어떤 불편함에 대해서도 사과드립니다	I apologize for any inconvenience caused by ~	I apologize for any inconvenience caused by my absence.
유감스럽게도 저는 ~할 수 없을 것 같습니다	I'm afraid I won't be able to 동사원형	I'm afraid I won't be able to join the meeting tomorrow.
~할 수 있으면 좋겠지만, 안타깝게도, ~합니다	I wish I could 동사원형, but unfortunately, 주어 + 동사	I wish I could take the course, but unfortunately, it conflicts with my schedule.
안타깝게도, ~으로 인해 현재로서는 A를 거절해야 할 것 같습니다	Unfortunately, I have to decline A at this time due to ~	Unfortunately, I have to decline the invitation at this time due to prior commitments.
~하는 것은 부담스럽지만, 대신 ~이라면 기꺼이 하겠습니다	I'm not comfortable with ~, though I'd be happy to 동사원형	I'm not comfortable with keeping your pet for a week, though I'd be happy to look after it for a day or two.
~으로 일정을 바꿀 수 있을까요?	Could we reschedule for ~?	Could we reschedule for after the midterm exams?
만약 그것이 당신에게 괜찮다면 ~할 수도 있을 것 같아요	Perhaps we could 동사원형 if that works for you	Perhaps we could meet after class if that works for you.
저에게 가장 힘든 부분은 ~이었습니다	The hardest part for me was ~	The hardest part for me was memorizing all the vocabulary.
A의 가장 좋은 점 중 하나는 ~입니다	One of the best things about A is ~	One of the best things about traveling is experiencing new cultures.
제가 가장 좋아했던 것은 ~이었습니다	What I liked most was ~ / The best part for me was ~	What I liked most was the dessert at the restaurant.
저에게 가장 인상 깊었던 것은 ~이었습니다	What impressed me most was ~	What impressed me most was the beauty of the landscape.
~는 잊을 수 없었습니다	주어 was unforgettable	The trip to Paris was unforgettable.
저는 특히 ~이 마음에 들었습니다	I especially liked ~	I especially liked how cozy the café was.
저는 ~을 정말 [특히] 즐겼습니다	I've really/especially enjoyed ~	I've really enjoyed taking your psychology class this semester.
~는 ~하는 훌륭한 방법이었습니다	주어 has been a great way to 동사원형	It has been a great way to spend my free time.
A는 B에게는 조금 과하게 ~하다고 느껴졌어요	I found A a bit too 형용사 for B	I found the soup a bit too salty for my taste.
~을 듣게 되어 (매우) 기쁩니다	I'm (so) excited to hear that 주어 + 동사	I'm excited to hear that you'll be visiting my city this summer.
~하려고 (시도)했지만, ~했습니다	I tried/attempted to 동사원형, but 주어 + 동사	I tried to join the debate club, but the registration had already closed.
~을 해보는 것을 추천합니다	I recommend trying ~	I recommend trying some relaxing activities like yoga or meditation.
~을 고려해 보세요	You might want to consider ~	You might want to consider meeting with the academic advisor.
최근에 ~을 발견했는데[~을 알게 되었는데], 당신과 공유하고 싶었습니다	I recently discovered/came across ~, and I wanted to share it with you	I recently discovered a website that offers free online courses, and I wanted to share it with you.
~에 대해 몇 가지 제안을 하고 싶습니다	I would like to make some suggestions for ~	I would like to make some suggestions for your travel itinerary.
~할 때 ~하는 것을 제안합니다	I suggest ~ when 주어 + 동사	I suggest reviewing your notes when the class ends.
~을 기꺼이 추천해 드리고 싶습니다	I'd love to recommend ~ / I'd be happy to recommend ~	I'd love to recommend a nice hiking trail outside the city.
~하기에 완벽한 환경이라고 생각합니다	I believe it would be the perfect environment to 동사원형	I believe it would be the perfect environment to meet people who share similar interests.
~하니, A가 이상적입니다	Since 주어 + 동사, A is ideal	Since you're interested in volunteering, this program is ideal.
저는 A가 ~에 좋은 [딱 맞는] 선택이라고 생각합니다	I think A would be a great choice / a perfect fit for ~	I think the evening flight would be a great choice for us.
A가 당신의 취향에 딱 맞을 거라고 확신합니다	I'm sure A totally suits your taste	Since you love cultural activities, I'm sure this festival totally suits your taste.
~하기 가장 좋은 시간[시기]는 ~입니다	The best time to 동사원형 is ~	The best time to go jogging is early in the morning when the air is fresh.
시작하는 가장 좋은 방법은 ~하는 것입니다	The best way to start is by ~	The best way to start is by practicing for 10 minutes a day.
~을 꼭 경험해봐/꼭 해보세요	Make/Be sure to check out ~	Make sure to check out the new cafe downtown.
~에 대해 알려 드리고자 합니다	I wanted to follow up on ~	I wanted to follow up on the status of the project.
~에 대해 몇 가지 피드백을 드리고 싶었습니다 [공유하고 싶었습니다]	I wanted to offer/share some feedback on ~	I wanted to offer some feedback on your presentation.
저는 ~에 대한 피드백을 드리기 위해 이메일을 쓰고 있습니다	I'm writing to provide feedback on ~	I'm writing to provide feedback on your report draft.
~는 ~을 훨씬 더 좋아지게 만들 수 있습니다	주어 could make ~ even stronger	A few adjustments could make the design even stronger.
한 가지 강화해야 할 부분은 ~입니다	One area to strengthen is ~	One area to strengthen is your use of supporting examples.
한 가지 개선해 보면 좋을 부분은 ~입니다	One thing you might consider improving is ~	One thing you might consider improving is the lighting in the dining area.
A가 ~한 이유는 ~하기 때문입니다	What makes A so 형용사 is that 주어 + 동사	What makes this tool so helpful is that it saves time.
~하는 것이 유익할 [도움이 될] 수도 있습니다	It might be beneficial/helpful to 동사원형	It might be beneficial to get feedback from others.
저는 ~하는 게 더 나을 것 같다고 생각합니다	I think it would be better to 동사원형	I think it would be better to keep it simple.
앞으로는[다음번에는], ~해 보세요	In the future / Next time, you can try to 동사원형	In the future, you can try to study in shorter sessions for better focus.
약간의 ~만 있다면, ~할 것이라고 확신합니다	With a bit of ~, I'm confident that 주어 + 동사	With a bit of effort, I'm confident that you can ace this subject.
